  0   0   0
  0   0   0
  0   0   0
  0   0   0
  0   0   0
  0   0   0
  0   0   0
  0   0   0
  0   0   0
  0   0   0
  0   0   0
  0   0   0
  0   0   0
  0   0   0
  0   0   0
  0   0   0
  0   0   0
  0   0   0
  0   0   0
  0   0   0
  0   0   0
  0   0   0
  0   0   0
  0   0   0
  0   0   0
  0   0   0
  0   0   0
  0   0   0
  0   0   0
  0   0   0
  0   0   0
  0   0   0
  0   0   0
  0   0   0
  0   0   0
  0   0   0
  0   0   0
  0   0   0
  0   0   0
  0   0   0
  0   0   0
  0   0   0
  0   0   0
  0   0   0
  0   0   0
  0   0   0
  0   0   0
  0   0   0
  0   0   0
  0   0   0
  0   0   0
  0   0   0
  0   0   0
  0   0   0
  0   0   0
  0   0   0
  0   0   0
  0   0   0
  0   0   0
  0   0   0
  0   0   0
  0   0   0
  0   0   0
  0   0   0
  0   0   0
  0   0   0
  0   0   0
  0   0   0
  0   0   0
  0   0   0
  0   0   0
  0   0   0
  0   0   0
  0   0   0
  0   0   0
  0   0   0
  0   0   0
  0   0   0
  0   0   0
  0   0   0
  0   0   0
  0   0   0
  0   0   0
  0   0   0
  0   0   0
  0   0   0
  0   0   0
  0   0   0
  0   0   0
  0   0   0
  0   0   0
  0   0   0
  0   0   0
  0   0   0
  0   0   0
  0   0   0
  0   0   0
  0   0   0
  0   0   0
  0   0   0
  0   0   0
  0   0   0
  0   0   0
  0   0   0
  0   0   0
  0   0   0
  0   0   0
  0   0   0
  0   0   0
  0   0   0
  0   0   0
  0   0   0
  0   0   0
  0   0   0
  0   0   0
  0   0   0
  0   0   0
  0   0   0
  0   0   0
  0   0   0
  0   0   0
  0   0   0
  0   0   0
  0   0   0
  0   0   0
  0   0   0
  0   0   0
  0   0   0
  0   0   0
  0   0   0
  0   0   0
  0   0   0
  0   0   0
  0   0   0
  0   0   0
  0   0   0
  0   0   0
  0   0   0
  0   0   0
  0   0   0
  0   0   0
  0   0   0
  0   0   0
  0   0   0
  0   0   0
  0   0   0
  0   0   0
  0   0   0
  0   0   0
  0   0   0
  0   0   0
  0   0   0
 28  12   0
 56  28   0
 84  40   0
112  52   0
140  68   0
168  80   0
196  92   0
224 108   0
252 120   0
252 148   0
252 172   0
252 200   0
252 224   0
252 252   0
252 216   0
252 176   0
252 140   0
252 100   0
232  92   0
212  84   0
192  76   0
176  68   0
156  60   0
136  52   0
116  48   0
 96  40   0
 76  32   0
 60  24   0
 40  16   0
 20   8   0
  0   0   0
  0   0   0
  0   0   0
  0   0   0
  0   0   0
  0   0   0
  0   0   0
  4   0   0
  4   0   0
  4   0   0
  4   0   0
  4   0   0
  4   4   4
  4   4   4
  4   4   4
  4   4   4
  4   4   4
  4   4   4
  4   4   4
  4   4   4
  4   4   4
  8   4   4
  8   4   4
  8   4   4
  8   4   4
  8   4   4
  8   4   4
  8   4   4
  8   4   4
  8   4   4
  8   4   4
  8   4   4
  8   4   4
  8   4   4
 12   8   8
 12   8   8
 12   8   8
 12   8   8
 12   8   8
 12   8   8
 12   8   8
 12   8   8
 12   8   8
 12   8   8
 12   8   8
 12   8   8
 12   8   8
 12   8   8
 16   8   8
 16   8   8
 16   8   8
 16   8   8
 16   8   8
 16   8   8
 16   8   8
 16   8   8
 16   8   8
 16  12  12
 16  12  12
 16  12  12
 16  12  12
 16  12  12
 20  12  12
 20  12  12
 20  12  12
 20  12  12
 20  12  12
 20  12  12
 20  12  12
 24  16  16
 32  20  20
  0   0   0
  0   0   0
  0   0   0
