  0   0   0
 28   0   0
 16   0   0
 44   0   0
 32   0   0
 60   0   0
 48   0   0
 76   0   0
 64   0   0
 92   0   0
 80   0   0
108   0   0
 96   0   0
124   0   0
112   0   0
140   0   0
128   0   0
156   0   0
144   0   0
172   0   0
160   0   0
188   0   0
176   0   0
204   0   0
192   0   0
220   0   0
208   0   0
236   0   0
224   0   0
252   0   0
240   0   0
240   0   0
252   0   0
224   0   0
236   0   0
208   0   0
220   0   0
192   0   0
204   0   0
176   0   0
188   0   0
160   0   0
172   0   0
144   0   0
156   0   0
128   0   0
140   0   0
112   0   0
124   0   0
 96   0   0
108   0   0
 80   0   0
 92   0   0
 64   0   0
 76   0   0
 48   0   0
 60   0   0
 32   0   0
 44   0   0
 16   0   0
 28   0   0
  0   0   0
 12   0   0
 12   0   0
  0   0   0
 28   0   0
 16   0   0
 44   0   0
 32   0   0
 60   0   0
 48   0   0
 76   0   0
 64   0   0
 92   0   0
 80   0   0
108   0   0
 96   0   0
124   0   0
112   0   0
140   0   0
128   0   0
156   0   0
144   0   0
172   0   0
160   0   0
188   0   0
176   0   0
204   0   0
192   0   0
220   0   0
208   0   0
236   0   0
224   0   0
252   0   0
240   0   0
240   0   0
252   0   0
224   0   0
236   0   0
208   0   0
220   0   0
192   0   0
204   0   0
176   0   0
188   0   0
160   0   0
172   0   0
144   0   0
156   0   0
128   0   0
140   0   0
112   0   0
124   0   0
 96   0   0
108   0   0
 80   0   0
 92   0   0
 64   0   0
 76   0   0
 48   0   0
 60   0   0
 32   0   0
 44   0   0
 16   0   0
 28   0   0
  0   0   0
 12   0   0
 12   0   0
  0   0   0
 28   0   0
 16   0   0
 44   0   0
 32   0   0
 60   0   0
 48   0   0
 76   0   0
 64   0   0
 92   0   0
 80   0   0
108   0   0
 96   0   0
124   0   0
112   0   0
140   0   0
128   0   0
156   0   0
144   0   0
172   0   0
160   0   0
188   0   0
176   0   0
204   0   0
192   0   0
220   0   0
208   0   0
236   0   0
224   0   0
252   0   0
240   0   0
240   0   0
252   0   0
224   0   0
236   0   0
208   0   0
220   0   0
192   0   0
204   0   0
176   0   0
188   0   0
160   0   0
172   0   0
144   0   0
156   0   0
128   0   0
140   0   0
112   0   0
124   0   0
 96   0   0
108   0   0
 80   0   0
 92   0   0
 64   0   0
 76   0   0
 48   0   0
 60   0   0
 32   0   0
 44   0   0
 16   0   0
 28   0   0
  0   0   0
 12   0   0
 12   0   0
  0   0   0
 28   0   0
 16   0   0
 44   0   0
 32   0   0
 60   0   0
 48   0   0
 76   0   0
 64   0   0
 92   0   0
 80   0   0
108   0   0
 96   0   0
124   0   0
112   0   0
140   0   0
128   0   0
156   0   0
144   0   0
172   0   0
160   0   0
188   0   0
176   0   0
204   0   0
192   0   0
220   0   0
208   0   0
236   0   0
224   0   0
252   0   0
240   0   0
240   0   0
252   0   0
224   0   0
236   0   0
208   0   0
220   0   0
192   0   0
204   0   0
176   0   0
188   0   0
160   0   0
172   0   0
144   0   0
156   0   0
128   0   0
140   0   0
112   0   0
124   0   0
 96   0   0
108   0   0
 80   0   0
 92   0   0
 64   0   0
 76   0   0
 48   0   0
 60   0   0
 32   0   0
 44   0   0
 16   0   0
 28   0   0
  0   0   0
 12   0   0
 12   0   0
