 32  16  16
 24  12  12
 16   8   8
  8   4   4
  0   0   0
  0   0   0
  0   0   0
  0   0   0
  0   0   0
  0   0   0
  4   0   0
  4   0   0
  8   0   0
  8   0   0
 12   0   0
 12   0   0
 16   0   0
 16   0   0
 20   0   0
 20   0   0
 24   0   0
 24   0   0
 28   0   0
 28   0   0
 32   0   0
 32   0   0
 36   0   0
 36   0   0
 40   0   0
 40   0   0
 44   0   0
 44   0   0
 48   0   0
 48   0   0
 52   0   0
 52   0   0
 56   0   0
 56   0   0
 60   0   0
 60   0   0
 64   0   0
 64   0   0
 68   0   0
 72   0   0
 72   0   0
 76   0   0
 76   0   0
 80   0   0
 80   0   0
 84   0   0
 84   0   0
 88   0   0
 88   0   0
 92   0   0
 92   0   0
 96   0   0
 96   0   0
100   0   0
100   0   0
104   0   0
104   0   0
108   0   0
108   0   0
112   0   0
112   0   0
116   0   0
116   0   0
120   0   0
120   0   0
124   0   0
124   0   0
128   0   0
132   0   0
132   0   0
136   0   0
136   0   0
140   0   0
140   0   0
144   0   0
144   0   0
148   0   0
148   0   0
152   0   0
152   0   0
156   0   0
156   0   0
160   0   0
160   0   0
164   0   0
164   0   0
168   0   0
168   0   0
172   0   0
172   0   0
176   0   0
176   0   0
180   0   0
180   0   0
184   0   0
184   0   0
188   0   0
188   0   0
192   0   0
196   0   0
196   0   0
200   0   0
200   0   0
204   0   0
204   0   0
208   0   0
208   0   0
212   0   0
212   0   0
216   0   0
216   0   0
220   0   0
220   0   0
224   0   0
224   0   0
228   0   0
228   0   0
232   0   0
232   0   0
236   0   0
236   0   0
240   0   0
240   0   0
244   0   0
244   0   0
248   0   0
248   0   0
252   0   0
252   0   0
248   0   0
244   0   0
240   0   0
240   0   0
236   0   0
232   0   0
228   0   0
224   0   0
220   0   0
220   0   0
216   0   0
212   0   0
208   0   0
204   0   0
200   0   0
200   0   0
196   0   0
192   0   0
188   0   0
184   0   0
180   0   0
180   0   0
176   0   0
172   0   0
168   0   0
164   0   0
160   0   0
160   0   0
156   0   0
152   0   0
148   0   0
144   0   0
140   0   0
140   0   4
136   0   4
132   0   4
128   0   4
124   0   4
120   0   4
120   0   4
116   0   4
112   0   4
108   0   4
104   0   4
100   0   4
100   0   4
 96   0   4
 92   0   4
 88   0   4
 84   0   4
 80   0   4
 80   0   4
 76   0   4
 72   0   4
 68   0   4
 64   0   4
 60   0   4
 60   0   4
 56   0   4
 52   0   4
 48   0   4
 44   0   4
 40   0   4
 40   0   4
 36   0   4
 32   0   4
 28   0   4
 32   4   8
 40   8  12
 48  12  16
 56  16  20
 64  20  24
 72  24  28
 80  28  32
 88  32  36
 96  36  40
104  40  44
112  44  48
120  48  52
128  52  56
136  56  60
144  64  64
148  68  68
156  72  72
164  76  76
172  80  80
180  84  84
188  88  88
196  92  92
204  96  96
212 100 100
220 104 104
228 108 108
236 112 112
244 116 116
252 120 120
244 116 116
236 112 112
228 108 108
220 104 104
212 100 100
204  96  96
196  96  96
188  92  92
180  88  88
172  84  84
164  80  80
156  76  76
148  72  72
144  68  68
136  64  64
128  60  60
120  56  56
112  52  52
104  48  48
 96  44  44
 88  44  44
 80  40  40
 72  36  36
 64  32  32
 56  28  28
 48  24  24
 40  20  20
