  0   0   0
156   8   4
160   8   4
164   8   4
168  12   4
172  12   8
176  12   8
180  12   8
184  12   8
188  16   8
192  16   8
196  16   8
200  16  12
204  16  12
208  16  12
212  20  12
216  20  12
220  20  12
224  20  12
228  20  16
232  24  16
236  24  16
240  24  16
  0   0   0
  0   0   0
  0   0   0
  0   0   0
  0   0   0
  0   0   0
  0   0   0
  0   0   0
  0   0   0
  0   0   0
  0   0   0
  0   0   0
  0   0   0
  0   0   0
  0   0   0
  0   0   0
  0   0   0
  0   0   0
  0   0   0
  0   0   0
  0   0   0
  0   0   0
  0   0   0
  0   0   0
  0   0   0
  0   0   0
  0   0   0
  0   0   0
  0   0   0
  0   0   0
  0   0   0
  0   0   0
  0   0   0
  0   0   0
  0   0   0
  0   0   0
  0   0   0
  0   0   0
  0   0   0
  0   0   0
  0   0   0
  0   0   0
  0   0   0
  0   0   0
  0   0   0
  0   0   0
  0   0   0
  0   0   0
  0   0   0
  0   0   0
  0   0   0
  0   0   0
  0   0   0
  0   0   0
  0   0   0
  0   0   0
  0   0   0
  0   0   0
  0   0   0
  0   0   0
  0   0   0
  0   0   0
  0   0   0
  0   0   0
  0   0   0
  0   0   0
  0   0   0
  0   0   0
  0   0   0
  0   0   0
 56   0  60
 68   8  72
 76  12  80
 88  20  92
 96  24 104
108  32 116
116  36 124
128  44 136
136  48 148
148  56 156
156  60 168
168  68 180
176  72 192
188  80 200
196  84 212
192  80 208
188  80 204
184  76 200
180  72 192
176  72 188
172  68 184
168  64 180
160  64 176
156  60 172
152  60 164
148  56 160
144  52 156
140  52 152
136  48 148
132  44 144
128  44 136
124  40 132
120  36 128
116  36 124
112  32 120
108  28 116
104  28 108
100  24 104
 92  24 100
 88  20  96
 84  16  92
 80  16  88
 76  12  80
 72   8  76
 68   8  72
 64   4  68
 56   0  60
 60   0  60
 64   0  64
 68   4  68
 72   4  72
 76   4  76
 80   8  80
 84   8  84
 92   8  84
 96  12  88
100  12  92
104  12  96
108  16 100
112  16 104
116  16 108
120  16 112
124  20 116
128  20 120
132  20 124
136  24 128
144  24 128
148  24 132
152  28 136
156  28 140
160  28 144
164  32 148
168  32 152
  0   0   0
  0   0   0
  0   0   0
  0   0   0
  0   0   0
  0   0   0
  0   0   0
  0   0   0
  0   0   0
  0   0   0
  0   0   0
  0   0   0
  0   0   0
  0   0   0
  0   0   0
  0   0   0
  0   0   0
  0   0   0
  0   0   0
  0   0   0
  0   0   0
  0   0   0
  0   0   0
  0   0   0
  0   0   0
  0   0   0
  0   0   0
  0   0   0
  0   0   0
  0   0   0
  0   0   0
  0   0   0
  0   0   0
  0   0   0
  0   0   0
  0   0   0
  0   0   0
  0   0   0
  0   0   0
  0   0   0
  0   0   0
  0   0   0
  0   0   0
  0   0   0
  0   0   0
  0   0   0
  0   0   0
  0   0   0
  0   0   0
  0   0   0
  0   0   0
  0   0   0
  0   0   0
  0   0   0
  0   0   0
  0   0   0
  0   0   0
  0   0   0
  0   0   0
  0   0   0
  0   0   0
  0   0   0
  0   0   0
  0   0   0
  0   0   0
  0   0   0
  0   0   0
  0   0   0
  0   0   0
  0   0   0
  0   0   0
 80   0   0
 84   0   0
 88   0   0
 92   0   0
 96   0   0
100   4   0
104   4   0
108   4   0
112   4   0
116   4   4
120   4   4
124   4   4
128   4   4
132   4   4
136   8   4
140   8   4
144   8   4
148   8   4
152   8   4
